bl,bl,bl,bl,bl,bl,bl,bl,bl,bl,bl,bl,bl,bl,bl
bl,-,-,-,-,-,-,-,-,-,-,-,-,-,bl
bl,-,-,-,-,-,-,-,-,-,-,-,-,-,bl
bl,-,-,-,-,-,-,-,-,-,-,-,-,-,bl
bl,-,-,-,-,-,-,-,-,-,-,-,-,-,bl
dr,-,-,-,-,-,-,-,-,-,-,-,-,-,bl
dr,-,-,-,-,-,-,-,-,-,-,-,-,-,dr
bl,-,-,-,-,-,-,-,-,-,-,-,-,-,dr
bl,-,-,-,-,-,-,-,-,-,-,-,-,-,bl
bl,-,-,-,-,-,-,-,-,-,-,-,-,-,bl
bl,bl,bl,bl,bl,bl,bl,bl,bl,bl,bl,bl,bl,bl,bl
